............................................................
....**********..............................................
.....**********.............................................
......********..............................................
............................................................
............................................................
............................................................
............................................................
............................................................
............................................................
........................................***.*...............
.................................**********.***.............
.................................**********$*...............
...........................................*................
............................................................
............................................................
............................................................
............................................................
............................................................
............................................................
............................................$$$$.$$$........
..........................................$$$...$$$.........
..........................................$$$$$$$$$$$$......
............................................$$$$$$$$$$$$$...
..............................................$$$$$$$.......
............................................................
***........................................~~~..............
****$.~~~~~~~~~~~....~~~~~~.............~~~~~~~~~..........!
~~~~~~~~~~~~~~~~~~~~~~~~~~~~~~~~~~~~~~~~~~~~~~~~~~~~~~~~~~~~
~~~~~~~~~~~~~~~~~~~~~~~~~~~~~~~~~~~~~~~~~~~~~~~~~~~~~~~~~~~~
